40
二千十七 OPERATOR 二百二十三 = 二千二百四十
二百五十 OPERATOR 六十五 = 一万六千二百五十
八千百二 OPERATOR 千七百四十七 = 六千三百五十五
六万九三七千十 OPERATOR 四十九九万二千 = 七万三
千二七万十二四 OPERATOR 六千五万一一百十六 = 五六四百千十八
三十一千万五一 OPERATOR 四七百七千 = 八十七百千七五一万
八百二千十七六 OPERATOR 百六一千六十 = 十千百四二四九
十五三 OPERATOR 十三二 = 九百十千二
百八七九千十四 OPERATOR 六百四 = 一四五十百万
万八十五百 OPERATOR 千万一四八九十百四 = 百六五千八万三
二百二七一千万十七 OPERATOR 四千一四十七万百三 = 四百十四二万
六九十百 OPERATOR 十七二 = 千四三十六百五
万千十百八八七四一 OPERATOR 千九三万一百三 = 九五十百七万
一十百万九三三 OPERATOR 五一二百千六十 = 千二万六十三
十四万四千五五三百 OPERATOR 千万六三六 = 四十四百万九一
九二三千二百十九万 OPERATOR 一七二一六万百十千 = 万三六百千六
一千四万百五 OPERATOR 十七四千二九百 = 百七千二六
八十三五千百三万 OPERATOR 二百九一十 = 万四五四千九十百三
万六二百千 OPERATOR 万二百十千二七四一 = 十三五百四八千
百六二八万 OPERATOR 千四万一七百六 = 千百四五一六万
百七三万十三 OPERATOR 百一一万四二十八千 = 十一百万五三六千
百十五五五千万七 OPERATOR 九五三千二百万十二 = 千万六百五一八
七二千百三 OPERATOR 六七百十 = 十一百二三千
一百七二十六万 OPERATOR 十千七万三百三 = 三千八十百三万四
百六十五 OPERATOR 十二五百 = 九八十三四万百千
十五百一八五万 OPERATOR 十二八百二千 = 百一七四千二万
九万百六二千七 OPERATOR 十五三九千 = 三千万四十六四八百
六五十千万八百八 OPERATOR 千九十万二百七 = 百六四八万九十
千四五 OPERATOR 三九千十六 = 十四千七七
七九三万千三百十 OPERATOR 五七六三十千百 = 百万十三九八
十万八六三百八六千 OPERATOR 六九六十万 = 十六二七四千百
万四九百五千十二六 OPERATOR 六千六五五万百 = 六九十千百七
百十四四五五万 OPERATOR 千百二二六十六三万 = 三三百八千三十
十四万八千八四百 OPERATOR 一百千八六六万 = 二万四三三十百
十千一百八八五八万 OPERATOR 十九二千二 = 九二六一十千万百八
三二二三千万十 OPERATOR 九千二一万十百九 = 千八十三二二百
八十百万二二千六八 OPERATOR 一万二五十五百 = 万一百二千十九八
十千二八百万六 OPERATOR 万二十七六 = 万百六八千十四二三
十二二九百万 OPERATOR 九三十三千 = 五百十千九五万九
四千八一二十万 OPERATOR 百八千七二 = 二一百十万八三
